1111111111111111111111
100000E000000000000001
100000000000000000C001
10000C0000C00000000001
1000000000000010000001
1000000000000000000001
10000000P0000000000001
1000000000000000000001
1111111111111111111111