111111111111111111111111
10000000000000000000C001
1000C001000C01000C000001
100000011000011000000001
10P0000100000C1000000001
10000000001001100000C001
10E000001010000000000001
1000C0011000000000000001
100000011111000000000001
10000C01100000C000000001
100000001000000000000001
10000000C000000000000001
100000000000000000000001
111111111111111111111111
