111111111111111111111111
1P000000000000000C000CE1
111111111111111101111111
100000000000000000000001
101111111111110011111001
10000C00000000001C000001
1111111101111111111111C1
1C000000011111111111C001
111111110100000011111001
1C0000000000CC001C000001
101011111100CC0011111101
111011111100000011C11101
10000000C111111111000001
111111111111111111111111