111111111111111111111111
100000000000000000000001
100000010000010000000001
1000P0011000011000000001
100000010000001000000001
111100000010011000000001
1001E0100000000101100110
111100011000000100100001
1000C0011111000111100001
100000011000000000000001
100000001000000000000001
100000000000000000000001
100000000000000000000001
111111111111111111111111
