111111111111111111111111
100000000000000000000001
100000010000010000000001
100000011000011000000001
100000010000001000000001
111100000010011000000001
1CE100001010000000000001
111100011000000000000001
100000011111000000000001
100000011000000000000001
100000001000000000000001
100000000000000000000001
10000000000000000000P001
111111111111111111111111
